browDownLeft = eCTRLBrowUp_DownL_NEGATIVE_
browDownRight = eCTRLBrowUp_DownR_NEGATIVE_
browInnerUp = eCTRLBrowInnerUp_Down
browOuterUpLeft = eCTRLBrowOuterUp_DownL
browOuterUpRight = eCTRLBrowOuterUp_DownR
cheekPuff = eCTRLCheeksBalloonPucker
cheekSquintLeft = 
cheekSquintRight = 
eyeBlinkLeft = eCTRLEyesClosedL
eyeBlinkRight = eCTRLEyesClosedR
eyeLookDownLeft = 
eyeLookDownRight = 
eyeLookInLeft = 
eyeLookInRight = 
eyeLookOutLeft = 
eyeLookOutRight = 
eyeLookUpLeft =
eyeLookUpRight =
eyeSquintLeft = eCTRLEyesSquintL
eyeSquintRight = eCTRLEyesSquintR
eyeWideLeft = eCTRLEyelidsLowerUpDownL_NEGATIVE_ AND eCTRLEyelidsUpperDownUpL_NEGATIVE_
eyeWideRight = eCTRLEyelidsUpperDownUpL_NEGATIVE_ AND eCTRLEyelidsUpperDownUpR_NEGATIVE_
jawForward = eCTRLJawOut_In
jawLeft = 
jawOpen = eCTRLMouthOpen AND eCTRLMouthOpenWide
jawRight = 
mouthClose = eCTRLMouthOpen_NEGATIVE_
mouthDimpleLeft =
mouthDimpleRight = 
mouthFrownLeft = eCTRLMouthSmileSimpleL_NEGATIVE_
mouthFrownRight = eCTRLMouthSmileSimpleR_NEGATIVE_
mouthFunnel = eCTRLLipsPuckerWide
mouthLeft = 
mouthLowerDownLeft = eCTRLLipBottomUp_DownL
mouthLowerDownRight = eCTRLLipBottomUp_DownR
mouthPressLeft = 
mouthPressRight = 
mouthPucker = eCTRLLipsPucker
mouthRight = 
mouthRollLower = eCTRLvM 
mouthRollUpper = eCTRLvM 
mouthShrugLower = eCTRLLipBottomIn_Out
mouthShrugUpper = eCTRLLipTopUp_Down
mouthSmileLeft = eCTRLMouthSmileSimpleL
mouthSmileRight = eCTRLMouthSmileSimpleR
mouthStretchLeft = eCTRLMouthSmileSimpleL_NEGATIVE_ AND eCTRLMouthNarrowL_NEGATIVE_
mouthStretchRight = eCTRLMouthSmileSimpleR_NEGATIVE_ AND eCTRLMouthNarrowR_NEGATIVE_
mouthUpperUpLeft = eCTRLLipTopUp_DownL
mouthUpperUpRight = eCTRLLipTopUp_DownR
noseSneerLeft = 
noseSneerRight = 